111111111111111
1E0C000000000C1
1C1111101111101
10100000111C101
101C11100000001
101111110111101
1P00000000000C1
111111111111111