111111111111111
1PECCCCCCC00001
111111111111101
1CC000000000001
111111111111111