111111111111111
1C00C00E00C00C1
1C11111C11111C1
1C10001C10001C1
1C10001C10001C1
1C11111C11111C1
1C00C00P00C00C1
111111111111111