111111111111111
1P0CCCCCCCCC001
100CCCCCCCCC001
1CCCCCCCCCCCCC1
1CCCCCCCCCCCCC1
100CCCCCCCCC001
100CCCCCCCCC0E1
111111111111111