111111111111111
100C01C000000C1
1C1000101111001
10111000111C101
100C01000000101
111101110111101
1PE00100000C1C1
111111111111111