111111111111111
1C10000001C0011
100010010001001
100100100100101
1C1001001C10001
110010010001101
1P01E0100000001
111111111111111