111111111111111
1C00000C00000C1
101111111111101
10100010001E101
1C0010001000101
111111111111101
1P0C000000000C1
111111111111111