111111111111111111111111111111
1P001C001C000001C00001C0000001
111010101C00010010100011111101
100010101111C01000101000000101
101110101000101111001001110101
1000001010101011C01001C1000101
111111000E1C001C00001C00010001
111111111111111111111111111111